11111111111111111111111
1C10000C10000010001C001
10000000000000000000001
11011100001111001000111
1E000000001111000000001
1111111100111100P000001
1C000001001111000001111
10000001000000000100001
1101110000000000010C001
1C000000000C10000100001
11111111111111111111111