111111111111111111111111111111111
1C10000C100000100000000001C000001
100000000000000000000000000001101
111111000011110010001100000000001
1E0000000011110000000000001111001
1111111100111100P00000000011110C1
1C0000010011110000011100001111001
100000010000000001000000000000001
1101110000000000010C0000000000001
1C000000000C10000100000000001C001
111111111111111111111111111111111